21
21
WWWWWWWWWWWWWWWWWWWWW
S       W     W   W W
W WWWWW WWW W W W W W
W     W     W W W   W
W WWWWWWWWWWWWW WWWWW
W W   W   W W   W   W
W W W WWW W W WWW W W
W   W   W W     W W W
W WWWWW W W W W W W W
W W   W     W W   W W
W WWW WWWWWWW WWWWW W
W W   W   W W W     W
W W W W W W W W WWW W
W W W W W   W W   W W
W W W WWWWW W WWW W W
W W W W     W W   W W
W W W W WWWWW WWWWW W
W W W   W   W   W W W
W W WWWWW W WWW W W W
W   W     W     W   E
WWWWWWWWWWWWWWWWWWWWW